8,8,8,8,8,8,8,8,8,8,8,8,8,8,8,8,8,8,8,8
8,8,8,8,8,8,8,8,8,8,8,8,8,8,8,8,8,8,8,8
8,8,8,8,8,0,0,0,0,0,0,0,0,0,0,8,8,8,8,8
8,8,8,8,8,0,1,0,0,0,2,0,3,0,0,8,8,8,8,8
8,8,8,8,8,0,0,1,2,3,0,0,0,0,2,8,8,8,8,8
8,8,8,8,0,0,0,0,0,0,0,2,0,0,0,0,8,8,8,8
8,8,8,8,0,0,2,3,0,0,1,3,0,2,0,0,8,8,8,8
8,8,8,8,8,0,0,0,1,0,0,0,3,0,0,8,8,8,8,8
8,8,8,8,8,0,1,3,0,0,1,0,0,0,2,8,8,8,8,8
8,8,8,8,8,0,0,2,0,0,3,0,2,0,0,8,8,8,8,8
8,8,8,8,8,8,8,8,8,8,8,8,8,8,8,8,8,8,8,8
8,8,8,8,8,8,8,8,8,8,8,8,8,8,8,8,8,8,8,8
